11111111111111111111
10000000000000000001
11111101111111111101
10000000000000000001
11111111110101111001
1E100000010100001001
1C111101010100111111
11110100111011000101
1P000000000000000001
11111111111111111111