11111111111111111111
10000000000000000001
11111101111111111101
10000000000000000001
10111111110101111001
100000000101000010E1
10111101010101111001
11110101111111111101
1P000000000000000101
11111111111111111111