1111111111
10010001C1
1000011001
1P1011E001
1111111111