11111111111111111111
1C000000000000000001
11111101111111111101
10000000000000000001
10111111110101111001
100000000101001C1001
10111101010100111101
11110100111011000101
1P0000000000000001E1
11111111111111111111