11111111111111111111
10100000000000000001
11111101111111111101
10000000000000000001
11100000010100001001
1C111111110101111001
1E111101010100111101
10110100111011000101
1P000000000000000001
11111111111111111111