11111111111111111111
10000000000000000001
11111101111111111101
10000000000000000001
10111111110101111001
10000000010100001001
10111101010100111101
11110100111011000101
1P00000000000000CE01
11111111111111111111