11111111111111111111
10100000000000000001
11111101111111111101
10000000000000000001
1E100000010100001001
11111111110101111001
1C111101010100111111
10010100111011000101
1P101000000000000011
1111111111111111111111