11111111111111111111
10100000000000000001
11111101111111111101
10000000000000000001
11100000010100001001
1E111111110101111001
1C111101010100111111
10010100111011000101
1P101000000000000011
11111111111111111111