11111111111111111111
1C0000000000000000E1
10111101111111111101
10000000000000000001
10000000010100001001
10111111110101111001
10111101010100111101
10110100111011000101
1P0000000000000000C1
11111111111111111111